111111111111111111111111111111
100000000000000000000000000001
100011110000111100000000000001
100000010000001000000000000001
100000010000000100000000000001
100000010000000100000000000001
100000010000001000000000000001
1000000100000001$0000000000001
100000000000000010000000000001
100000000000000010000000000001
100000000000000000000000000001
100000000011110111100000000001
100000000000000000000000000001
100000000000000000000000000001
111111111111111111111111111111
