111111111111111111111111111111
100000000000000000000000000001
100111110000111100000100000001
100000010000001000000100000001
100000010000000100000100000001
100000010001111100000100000001
100000010000001000000100000001
1000000100000001#0000111000001
100000010000000010100001000001
101111110000000010100001000001
100000000000000000100001000001
100000000011110111100000000001
100000000010000000100000000001
100000000000000000000000000001
111111111111111111111111111111
