111111111111111111111111111111
100000000000000000000000000001
100000000011100000000001000001
100000100100001000000001000001
100000100100000001111001000001
100000100100000010001111000001
100000100100000010000001000001
100000100100000011000001000001
100000100100000000000101110001
100000100011100001000000000001
100000110000111110000000000001
100000000000000000001010000001
100100001111110000000001$00001
100100000000000000000000000001
111111111111111111111111111111
