111111111111111111111111111111
100000000000000000000000000001
100000000011100000000000000001
100000100100001000000000000001
100000100100000001111000000001
100000100100000010001111000001
100000100100000010000001000001
100000100100000011000001000001
100000100100000000000101100001
100000100011100001000000000001
100000110000111110000000000001
100000000000000000001010000001
1000000011111100000000010A0001
100000000000000000000000000001
111111111111111111111111111111
