111111111111111111111111111111
100000000010000000000000000001
100000000011100000010001111001
100000110000001000010001000001
100000100100000001111001000011
100111100100000010001111000101
101000100111000010000001001001
101000100100000011000001000001
101000100100000000000101110001
101000100011100001000000010001
101000110000111110000000011101
100000000000000000001010000101
100100001111110000000001A00001
100100000000000001101000000001
111111111111111111111111111111
