111111111111111111111111111111
100000000100000000000000000001
1000111101001111001111111@0001
100010010101001001000001000101
100010010000000101010101010101
100010000010000101010101010101
100010010010010001000101011001
100010010010100100010100000101
100010010011000100010011100001
100010010001000001010000000011
100010010001000000000000010011
101110010000110111100000010001
101000011100100000100000011001
100000000000000000000000000001
111111111111111111111111111111
