111111111111111111111111111111111111111111111111111111111111
10010000000000000*000000000000000000000000100000000000000001
1001000*0000000000000000000000000000000000111111111111111001
1001001111111111111111100111111111111111#0000000000000001001
100100111111111111111110010000000000000100000000000000001001
100100111111111111111110010000000000000111111111111111001001
1001*011111111111111111001001111111110#000000001111111001*01
100100111111111111111110010*1111111110000000*0011111110*1001
100000111111111111111110010011111111111111111001000001001001
100000111111111111111111110011111111111111111001*00001001001
100111111111111111111110000011111111111111111001111001000001
10010000000000000*00000000000000000001111111#000000001000001
1001000*0000000000000000000000*00000011111110000000001111001
100100111111111111111111111111111111110000010011111111111#01
100100000000#00000*00000000000000111110000010000000000000001
100100000#00000*00000000000000000111110010*10000*00000000001
100111111111111111111111111111100111110010011111111111111111
10000000000000000*00000000000010000*00001000000000*000000001
100000*00000000000000000000000100000000010000000000000000201
111111111111111111111111111111111111111111111111111111111111
