1111111111
1001110001
1010010001
1000010001
1010$10001
1010010001
1011111001
1000001001
1111001001
1000001001
1011111001
1010000001
1011111001
1000000001
1111111111
