1111111111
1000001001
1001101001
1001000001
1001$01001
1001111001
1&00000001
1000001111
1111000001
1000011001
10011000#1
1000011001
1110000011
1$01110001
1111111111
