1111111111
1000010001
1011010001
1010000001
1010$10001
1010010001
1011010001
1010011001
1000001001
1000011001
1000010001
1001100001
1000000001
1000000001
1111111111
