1111111111       1111111111111111111111111
10INICIO01       1000000000000000000000001
1000000001       1000000000000000111100001
1000000001       10000000000000001  100001
1000000001       10000000000000001  100001
1000000001               100000001  100001
1000000001               10&FIN001  100001
1000000001               111111111  100001
1000000001                          100001
1000000001                          100001  
1000000001                          100001
1000000001111111111111111111111111  100001
1000000000000000000000000000000001  100001 
1000000000000000000000000000000001  100001
1111111111111000001111111111111111  100001
            1000001                 100001
111111111111100000111111111111111111000001
100000000000000000000000000000000000000001
100000000000000000000000000000000000000001
100000000000000000000000000000000000000001
111111111111111111111111111111111111111111