1111111111
1000000001
1011110001
1010010001
1010010001
1010011001
1010000001
1010000001
1011000001
1001000001
1001000001
100010A001
1000100001
1000000001
1111111111
